Species	Status
Canis	extinct
Canis_(Pseudalopex)	extinct
Canis_adustus	extant
Canis_anthus	extant
Canis_apolloniensis	extinct
Canis_armbrusteri	extinct
Canis_aureus	extant
Canis_cedazoensis	extinct
Canis_dirus	extinct
Canis_edwardii	extinct
Canis_familiaris	extant
Canis_ferox	extinct
Canis_latrans	extant
Canis_lepophagus	extinct
Canis_lupus	extant
Canis_mesomelas	extant
Canis_proplatensis	extinct
Canis_rufus	extant
Canis_thooides	extinct
Pseudalopex_gymnocercus	extant
